p p p p 0 0 0 0 0 0 0 L 0 0 0 0 0 0 0 0 0 0 0 0 0 N N N N N N 0 0 0 0 0 0 0 0 0 0 0 0 0 l 0 0 0 0 0 0 0 P P P P
p p p p 0 0 0 0 0 0 0 L 0 0 0 0 0 0 0 0 0 0 0 0 0 N N N N N N 0 0 0 0 0 0 0 0 0 0 0 0 0 l 0 0 0 0 0 0 0 P P P P
A 0 0 0 0 0 0 0 0 0 0 L 0 0 0 0 0 0 0 0 0 0 0 0 0 N N N N N N 0 0 0 0 0 0 0 0 0 0 0 0 0 l 0 0 0 0 0 0 0 0 0 0 a
A 0 0 0 0 0 0 0 0 0 0 L 0 0 0 0 0 0 0 0 0 0 0 0 0 N N N N N N 0 0 0 0 0 0 0 0 0 0 0 0 0 l 0 0 0 0 0 0 0 0 0 0 a
A 0 0 0 0 0 0 0 0 0 0 L 0 0 0 0 0 0 0 0 0 0 0 0 0 N N N N N N 0 0 0 0 0 0 0 0 0 0 0 0 0 l 0 0 0 0 0 0 0 0 0 0 a
A 0 0 0 0 0 0 0 0 0 0 L 0 0 0 0 0 0 0 0 0 0 0 0 0 N N N N N N 0 0 0 0 0 0 0 0 0 0 0 0 0 l 0 0 0 0 0 0 0 0 0 0 a
A 0 0 0 0 0 0 0 0 0 0 L 0 0 0 0 0 0 0 0 0 0 0 0 0 N S S S S N 0 0 0 0 0 0 0 0 0 0 0 0 0 l 0 0 0 0 0 0 0 0 0 0 a
A 0 0 0 0 0 0 0 0 0 0 L 0 0 W W W W C 0 0 0 0 0 0 N S T T S N 0 0 0 0 0 0 c w w w w 0 0 l 0 0 0 0 0 0 0 0 0 0 a
A E E E 0 0 0 0 0 0 0 L 0 0 W T T W 0 0 0 0 0 H H H S S S S h h h 0 0 0 0 0 w T T w 0 0 l 0 0 0 0 0 0 0 0 0 0 a
B E E E 0 0 0 0 0 0 0 L 0 0 W W W W C 0 0 0 0 H H H H T T h h h h 0 0 0 0 c w w w w 0 0 l 0 0 0 0 0 0 0 0 0 0 a
B E E E 0 0 0 0 0 0 0 L 0 0 T T T T 0 0 0 0 0 H H H H T T h h h h 0 0 0 0 0 T T T T 0 0 l 0 0 0 0 0 0 0 0 0 0 a
A E E E 0 0 0 0 0 0 Z Z Z Z T T T T C 0 0 0 0 H H H H T T h h h h 0 0 0 0 c T T T T z z z z 0 0 0 0 0 0 0 0 0 a
A 0 0 0 0 0 0 0 0 0 Z Z Z Z T T T T 0 0 0 0 0 H H H H T T h h h h 0 0 0 0 0 T T T T z z z z 0 0 0 0 0 0 0 0 0 a
A 0 0 0 0 0 0 0 0 0 Z Z Z Z T T T T 0 0 0 0 0 H H H H T T h h h h 0 0 0 0 0 T T T T z z z z 0 0 0 0 0 0 0 0 0 a
A 0 0 0 0 0 0 0 0 0 Z Z Z Z T T T T C 0 0 0 0 H H H H T T h h h h 0 0 0 0 c T T T T z z z z 0 0 0 0 0 0 e e e a
A 0 0 0 0 0 0 0 0 0 0 L 0 0 T T T T 0 0 0 0 0 H H H H T T h h h h 0 0 0 0 0 T T T T 0 0 l 0 0 0 0 0 0 0 e e e b
A 0 0 0 0 0 0 0 0 0 0 L 0 0 V V V V C 0 0 0 0 H H H H T T h h h h 0 0 0 0 c v v v v 0 0 l 0 0 0 0 0 0 0 e e e b
A 0 0 0 0 0 0 0 0 0 0 L 0 0 V T T V 0 0 0 0 0 H H H s s s s h h h 0 0 0 0 0 v T T v 0 0 l 0 0 0 0 0 0 0 e e e a
A 0 0 0 0 0 0 0 0 0 0 L 0 0 V V V V C 0 0 0 0 0 0 N s T T s N 0 0 0 0 0 0 c v v v v 0 0 l 0 0 0 0 0 0 0 0 0 0 a
A 0 0 0 0 0 0 0 0 0 0 L 0 0 0 0 0 0 0 0 0 0 0 0 0 N s s s s N 0 0 0 0 0 0 0 0 0 0 0 0 0 l 0 0 0 0 0 0 0 0 0 0 a
A 0 0 0 0 0 0 0 0 0 0 L 0 0 0 0 0 0 0 0 0 0 0 0 0 N N N N N N 0 0 0 0 0 0 0 0 0 0 0 0 0 l 0 0 0 0 0 0 0 0 0 0 a
A 0 0 0 0 0 0 0 0 0 0 L 0 0 0 0 0 0 0 0 0 0 0 0 0 N N N N N N 0 0 0 0 0 0 0 0 0 0 0 0 0 l 0 0 0 0 0 0 0 0 0 0 a
A 0 0 0 0 0 0 0 0 0 0 L 0 0 0 0 0 0 0 0 0 0 0 0 0 N N N N N N 0 0 0 0 0 0 0 0 0 0 0 0 0 l 0 0 0 0 0 0 0 0 0 0 a
A 0 0 0 0 0 0 0 0 0 0 L 0 0 0 0 0 0 0 0 0 0 0 0 0 N N N N N N 0 0 0 0 0 0 0 0 0 0 0 0 0 l 0 0 0 0 0 0 0 0 0 0 a
p p p p 0 0 0 0 0 0 0 L 0 0 0 0 0 0 0 0 0 0 0 0 0 N N N N N N 0 0 0 0 0 0 0 0 0 0 0 0 0 l 0 0 0 0 0 0 0 Q Q Q Q
p p p p 0 0 0 0 0 0 0 L 0 0 0 0 0 0 0 0 0 0 0 0 0 N N N N N N 0 0 0 0 0 0 0 0 0 0 0 0 0 l 0 0 0 0 0 0 0 Q Q Q Q