R 0 0 0 0 0 0 0 0 X
0 0 0 0 0 X 0 0 X F
0 0 X X X 0 0 X 0 0
0 0 0 0 0 0 0 0 0 0
0 0 0 0 0 0 X 0 0 0
0 0 X X 0 0 X 0 0 0
0 0 0 0 X 0 0 0 0 0
0 0 0 0 0 X X X 0 0
0 0 0 0 0 0 0 X 0 0
0 0 0 0 0 0 0 0 X F

